............................
............................
............................
############################
#............##............#
#.####.#####.##.#####.####.#
#.####.#####.##.#####.####.#
#.####.#####.##.#####.####.#
#..........................#
#.####.##.########.##.####.#
#.####.##.########.##.####.#
#......##....##....##......#
######.#####.##.#####.######
.....#.#####.##.#####.#.....
.....#.##..........##.#.....
.....#.##.###--###.##.#.....
######.##.#......#.##.######
..........#......#..........
######.##.#......#.##.######
.....#.##.########.##.#.....
.....#.##..........##.#.....
.....#.##.########.##.#.....
######.##.########.##.######
#............##............#
#.####.#####.##.#####.####.#
#.####.#####.##.#####.####.#
#...##................##...#
###.##.##.########.##.##.###
###.##.##.########.##.##.###
#......##....##....##......#
#.##########.##.##########.#
#.##########.##.##########.#
#..........................#
############################
............................
............................